AAA : UPON
AAV : DERIVATIVE
AAY : EXCLUDE
ABA : DISCIPLINARIAN
ABH : RANDOM
ABM : DISHONESTY
ABW : RSABASED
ACC : MISTER
ACL : KNOWN
ADA : TRANSFEREE
ADB : TRIANGULATE
ADL : CYBER
ADM : SNEAK
ADP : ENTITLE
ADV : TRIPLICATE
AEH : DEMYSTIFICATION
AEO : DEMIMONDAINE
AEP : TRANSFUSION
AGQ : MAXIMAL
AHJ : NETWORK
AHP : TEMPORALITY
AJE : STRONGER
AJH : UNTIL
AJR : WITH
AJT : MONITORED
AKE : EXACTLY
AKH : TRAILBREAKER
AKL : DESTINY
AKN : DISACCHARIDE
AKZ : WOMEN
ALL : WORK
ALT : BLEED
ALX : REPLACING
AMC : DEPRESSING
ANG : BADGUYS
ANM : FACTOR
ANQ : THYROIDITIS
ANY : DECARBOXYLASE
AOA : MONTHLY
AOG : SPITE
AOU : TOMOGRAPHY
AOZ : PARTICULAR
APD : ACTIVITIES
APH : TRANSMOGRIFY
APY : DESEXUALIZATION
AQI : DISRESPECTABLE
ARD : HIDDEN
ARI : PERFECTED
ARX : WHOM
ARY : POINTS
ARZ : TOOTHBRUSH
ASL : IRISHMAN
ATB : DETACHEDNESSES
ATC : ELASTIC
ATK : DISCRIMINATING
ATQ : EVENT
ATW : AGAIN
AUC : THERMOCOUPLE
AUD : RANK
AUH : TATE
AUJ : ELEVATE
AUK : TETHERED
AVR : TECHNETRONIC
AVZ : ENHANCE
AWA : DEMONETIZATION
AWE : MUCH
AWW : DEGLACIATION
AXC : CLATTER
AXG : DENAZIFICATION
AXQ : REPRESENTATIVE
AXT : FIPS
AXW : DRAUGHTSMAN
AYA : TRANQUILLITY
AYR : TRIVIALIZE
AZQ : TECHNOCRACY
BAP : DISHWASHER
BAU : DISTINGUISHED
BBO : SYSTEM
BBT : BAFFLED
BBW : TREPIDATION
BBZ : COLLECTED
BCA : DOMINATION
BCF : ECONOMY
BCX : NEXT
BDX : SEE
BEB : DOUBLEHEADERS
BEL : CORRECTEDIN
BER : TURBOCHARGED
BES : FEEL
BFH : SUFFRAGES
BFK : DIVERTICULITIS
BFL : MANDATE
BFW : ERRORS
BGH : INDEFEASIBLE
BGI : DIFFERENCES
BGM : ENVIOUS
BGP : GATE
BGU : TIEBREAKER
BHM : LIFE
BHQ : DISINTEGRATE
BIB : TOURNAMENT
BIN : HE
BIU : TRIGLYCERIDE
BJR : TRANSPLANT
BKB : PERFORM
BKE : DAY
BKJ : DENATIONALIZE
BKQ : DEFENSIVENESSES
BLM : CHECKED
BLR : DICHLOROETHANES
BMG : MUSICAL
BMI : DETECTION
BMJ : ELECTED
BMK : TOBACCONIST
BMM : BASE
BMR : THUNDERCLOUD
BMS : DISORDERLY
BNS : DISHARMONIOUS
BNV : LEADS
BOB : NEGLECTED
BOG : DESTRUCTIONIST
BOI : TRANSFERENCE
BOO : DISOBEDIENCE
BOP : ESTABLISHED
BOW : BELIEVED
BOX : DOGGISHNESSES
BPH : TRANSVERSAL
BQN : DECALCIFICATION
BRL : UNDERSTANDING
BRP : THOROUGHBASS
BRS : MAKE
BSF : MAXWELL
BSG : TELLUROMETER
BSS : BY
BTA : WISDOM
BTN : DEGRADATION
BUM : DESTRUCTIVITIES
BVD : DIPLOMATIC
BVH : DICARBOXYLIC
BWH : CONTRADICT
BWN : DEPRECIABLE
BWW : EVENING
BXI : INITIATIVE
BXM : DENSITOMETER
BXN : ITSELF
BXP : SUCCESS
BXR : IMPORTANT
BXT : DERMATOLOGY
BXV : OUTBREAK
BYW : TRIBESPEOPLE
BZO : DODECAHEDRONS
BZP : DISLOCATION
BZW : GENEROUS
CAM : STRUCTURE
CAN : TRANSCENDENT
CAO : TRYPANOSOME
CAY : GATES
CBF : FULL
CBK : DELEGITIMATIONS
CBU : DIPHENHYDRAMINE
CBY : DISPOSITION
CCD : AVAILABLE
CCG : ALGEBRAIC
CCI : THEREINAFTER
CCM : WRONG
CCN : THEY
CDG : CHURN
CDN : NATIONHOOD
CDS : MADE
CDU : TYPOGRAPHY
CEF : DETERMINE
CEK : DISINTERESTED
CET : PUBLICKEY
CEW : ALLIES
CFD : DORSOVENTRAL
CFE : DISAPPOINTED
CFO : ENLARGE
CFX : YOUR
CGQ : TEMPERANCE
CGV : EXPLAINING
CHF : TORRENTIAL
CHJ : OF
CHU : EXPERIMENTS
CHV : PROSPECT
CIO : BIT
CIX : TIGHTFISTED
CIY : VICTORY
CJD : DELIGHTFUL
CJS : DISCRIMINABLE
CKM : OLD
CKN : DRAFTSPERSONS
CLO : MINIVAN
CLX : CORRUPTED
CMM : MAINTENANCE
CMQ : DETERMINATIVE
CMR : DOCUMENTARIES
CMT : DETERMINES
CNG : DOLICHOCEPHALIC
CNM : DEFERENTIAL
CNY : DESPERATENESSES
COF : MARQUEE
COO : OUT
COS : LOGIN
COU : PREPARED
COX : PAST
COZ : WAR
CPI : DISCONNECTED
CPV : TRUTHFUL
CRC : DYSFUNCTION
CRO : DEPARTMENTALIZE
CRQ : DEHYDROGENATE
CRV : TRANSPONTINE
CSA : DEFENESTRATION
CSI : DISCIPLINE
CSS : EMPRESS
CSU : DISTRIBUTE
CSY : DISSATISFACTION
CTE : EXPLAIN
CTG : TRANSMITTAL
CTN : COMMANDER
CUD : SECURE
CUI : THEN
CUN : DISINVESTMENT
CUR : DISJOINTED
CUS : GOOD
CVI : PROOF
CVR : FREEDOMS
CVZ : ONE
CWB : ENABLES
CWE : DISINTOXICATE
CWH : LEGAL
CWJ : DISTANCES
CWY : THERMOPHILIC
CXE : CODE
CXZ : EMOTIVE
CYR : DETONABILITIES
CYV : ERUDITE
CZC : MEMENTO
CZM : DESULTORINESSES
CZS : INITIAL
CZZ : FINDING
DAA : RAISE
DAL : INFINITY
DAZ : MAJORITY
DBC : TERRITORY
DBF : ADVANTAGES
DBG : MEASLES
DBM : PLACE
DBS : MAY
DCH : ALL
DCK : THATS
DCW : DEPHOSPHORYLATE
DDE : CHOSEN
DDK : DELINQUENCY
DDS : OFFICERS
DEB : DREADNOUGHT
DEY : TRACHEOSTOMY
DFA : CAUSE
DFD : POPULATION
DFJ : ASSERTING
DGD : DEMYTHOLOGIZER
DGM : EXERCISE
DGV : PROTOCOLS
DHE : CONFIDENCE
DIJ : CIVIL
DIK : PRESENTING
DJS : HEARTACHE
DKU : PAGES
DLN : DICTATORSHIP
DLS : DENOTED
DLW : DENATIONALIZING
DMG : FOSTERED
DNA : DYNAMOMETER
DNF : MENTION
DNP : SET
DNV : DEMONSTRATOR
DNW : DEPRESSIVE
DOB : DISCONTINUANCE
DOE : FIND
DOK : HEART
DOO : LADDER
DOS : PRIOR
DOV : DESALINIZATIONS
DPA : DISCOUNTENANCE
DPI : ECSTASY
DPV : THERETOFORE
DQH : MIDSIZE
DQJ : DECOMMISSION
DQS : EXTINCT
DRL : THIS
DSG : DEMULTIPLEXERS
DSJ : AYE
DSQ : TONSILLITIS
DTX : DISCURSIVE
DUJ : SOVEREIGNS
DUK : EXTREME
DUO : MOLDING
DUV : PROTECTION
DUZ : SAFETY
DVG : LENNY
DVM : US
DVX : NOT
DVY : TYRANNICAL
DVZ : DEPARTMENT
DWB : DESACRALIZATION
DWK : PLANE
DWR : DODECAHEDRON
DWX : PACKAGE
DXB : INVOKE
DXF : REPUBLICAN
DXV : DEPENDENCY
DXW : DOMINEERING
DYK : TECHNETIUM
DZG : TERRESTRIAL
DZO : DEMOCRATIZATION
EAM : THEIR
EBW : THERAPEUTIC
ECE : TENDENTIOUS
ECR : EVIDENT
ECT : DISPUTATIOUS
ECZ : NIGHT
EDB : TRICKING
EDE : TESTIMONIAL
EDF : ERASURE
EDH : DEMONSTRATIONS
EED : THEOLOGIAN
EER : DETERMINISM
EEW : CONSENT
EEY : CHERISHING
EFJ : EMBASSY
EFQ : TECHNICALITY
EFS : DISPLACEMENT
EGI : PATENTS
EGJ : TRAVERTINE
EGK : HIS
EGM : PLEASE
EHE : LEFT
EHK : DAGUERREOTYPE
EHM : SOFTWARE
EHN : MIDTOWN
EHR : BIRDS
EIP : NEW
EIS : SEEKING
EIU : TRANQUILIZER
EJA : TRUMPED
EJB : ORIONS
EJR : AFFORDED
EKF : DEUTERANOPIA
EKK : WATER
EKN : RESPECTEDIT
EKR : TURBOCHARGER
ELD : REENCRYPTION
ELR : PRIMITIVES
EMF : DEPOLYMERIZE
EMT : TREASONABLE
EMU : MICROSOFT
EMW : WALLS
END : PERHAPS
ENM : TRICERATOPS
ENS : FEW
ENY : FULLEST
EOF : CAREFULLY
EOO : TRUSTEESHIP
EOZ : TRANSITION
EPG : DETECTABILITIES
EPJ : TRANSFERRIN
EPM : MANKIND
EPT : MASTERY
EQO : HIT
EQV : DEFORMATION
ERB : DESPIRITUALIZES
ERI : TROJANED
ERS : TRANSMISSION
ESD : TITLEHOLDER
ESO : TECHNOBABBLE
ESR : EQUALLY
ESW : DISSATISFACTORY
ESX : CONTINUED
ETL : PLACED
ETO : TOOL
ETP : CONCERNED
EUB : DURING
EUE : THERAPEUTICS
EUM : LISTEN
EVC : DISTRIBUTIVE
EVD : PERSPECTIVE
EVM : THERMOSTAT
EWU : DONE
EWZ : DIAMONDIFEROUS
EXH : DIABOLICALNESS
EXI : MALWARE
EXN : DISASSOCIATE
EXV : DISAPPROVAL
EYE : EARTHQUAKE
EYF : ENTRUST
EZD : EYESORE
EZL : DIFFERENCE
FAA : UNCLASSIFIED
FBH : STAR
FBL : CITY
FCD : DEMAGOGUERY
FCH : TURGIDNESSES
FCX : COVERING
FDB : DUMBFOUNDERED
FDE : DICTATORIAL
FDZ : DISCOURAGEMENT
FEA : TOO
FFE : DATA
FFJ : DEMODULATION
FFL : TYMPANITESES
FFS : DESSERTSPOONFUL
FGK : SOURCE
FGV : DEPIGMENTATIONS
FGX : THUNDEROUS
FHC : BEFORE
FHD : CONTRACT
FHG : ELEGANT
FHH : DISORIENTATION
FHL : IT
FHN : FEAR
FHR : COWARDICE
FHW : DISASSEMBLE
FIC : DIVERTICULUM
FJM : MASSAGE
FKD : INHUMANITY
FKH : STATES
FKP : MESSAGE
FLC : DOLPHINFISHES
FLK : DISCORDANT
FLT : TEASPOONFUL
FMB : MILEAGE
FMC : DRAPABILITIES
FMH : METHANE
FNB : DISCOTHEQUE
FNG : TRICHINOSIS
FNH : LOGARITHM
FNM : FUNDAMENTAL
FOC : DELOCALIZATIONS
FOF : VICTORIOUS
FON : DEMISEMIQUAVERS
FOP : DENUMERABILITY
FOV : TAKING
FOX : HORSE
FPB : IF
FPC : ACCORD
FPD : DEMONSTRABLE
FPW : THUMBPRINT
FQK : DETESTABLENESS
FQS : WHO
FRO : TORTICOLLIS
FSA : TRANSFORMER
FSB : TRAPSHOOTING
FSF : RULES
FSK : DLL
FSM : DISTRACTION
FSQ : TRANSPARENT
FSS : ADHERENCE
FSU : DISCRIMINATORY
FSW : DISSERVICE
FSZ : DEMOLITION
FTE : TRANSOCEANIC
FUG : GAIN
FUN : DELIVERABILITY
FUP : EQUAL
FUR : DRYOPITHECINE
FUT : BASIS
FVH : SUBMARINES
FVM : DINITROBENZENE
FVY : EXCEPT
FWD : TRIPARTITE
FWF : FILE
FWI : SOVEREIGNTY
FXF : HOW
FXR : DISINTEGRATION
FYV : INTEREST
FZA : DIAGNOSTIC
FZZ : EVERYTHING
GAB : DESTRUCTIVENESS
GAJ : ENLIVEN
GAM : TRACHEOTOMY
GAZ : MULTIPLICAND
GBE : COMPLAINT
GBS : ASSERTED
GBW : DICTIONARY
GCM : IRISHWOMAN
GCS : CUSTOMERS
GDI : TUBERCULOUS
GDN : TITANIFEROUS
GEA : SATISFACTORY
GEB : DOLTISHNESSES
GEF : ENTIRE
GEN : DELIBERATENESS
GEQ : DIFFERENTIAL
GFE : ETHANOL
GGE : TAKEN
GGM : AEROPLANES
GGX : TRIGONOMETRY
GHX : DIVERGENCE
GIG : BUILD
GIX : PATENT
GIY : DELINQUENT
GJD : DEFEMINIZATIONS
GJH : CALLED
GJI : HERE
GJO : WARFARE
GJU : DISPUTATION
GKB : DEMOGRAPHICALLY
GKI : STATE
GKQ : TOURMALINE
GKT : DESERVING
GKV : DISTORTION
GLC : POCKETFUL
GLQ : TO
GLS : VOLUNTEERS
GMB : DEDICATION
GMF : DISQUISITION
GMI : COMPUTE
GMU : TYPESETTINGS
GMW : TRANSISTOR
GMZ : CRAZY
GOJ : DISCRIMINATIVE
GPA : HAPPINESS
GPV : FINITE
GQA : ENDORSE
GQN : PROCESSED
GQO : WHENEVER
GQP : DELIBERATION
GQQ : DEMYTHOLOGIZE
GQS : DISSERTATION
GQW : ACTIVITY
GRR : SERVER
GTB : ETHICAL
GTL : DISCONNECT
GTN : TRANSALPINE
GUA : DIEFFENBACHIA
GUO : THERMISTOR
GUX : DISSIPATED
GVD : EPITAPH
GVO : PERMANENT
GWZ : IMMEDIATE
GXI : EXTRA
GXJ : THIORIDAZINE
GXN : DISMISSIVE
GYN : MISSION
GYV : TOP
GYW : DENUCLEARIZE
HAF : DOWNTRODDEN
HAG : RESOLVED
HAY : SUNBURST
HBF : THUNDERSTONE
HCA : SUPPLIES
HCE : MEN
HCL : GRAY
HCZ : FIRE
HDN : TELEVISION
HDP : TRANSMIGRATE
HDQ : FIELD
HDW : DINOFLAGELLATE
HEC : DETRIMENTAL
HEE : DEMYELINATIONS
HEI : WARRIORS
HEV : HOWEVER
HEX : LONELY
HFG : CAGE
HFL : MISSILE
HFM : SEASONS
HGI : DELEGATION
HGL : DISINFORMATION
HGQ : ENSURING
HGY : STORED
HHD : KEY
HHM : DEACIDIFICATION
HHQ : DERIVATION
HHY : HEAT
HIC : INNOCUOUS
HID : DODECAPHONIC
HII : SERIOUSLY
HIO : PUBLIC
HIW : VARIOUS
HJA : STRIVE
HJD : IMPLEMENTED
HJJ : NECK
HJX : USE
HKC : THOUGHTFULLY
HKD : COPY
HKP : DESTRUCTIBILITY
HKT : DICHOTOMIZATION
HLU : CERTAIN
HLV : WITHIN
HML : ONCE
HOJ : DISAFFECTED
HOL : APPLY
HOM : TALL
HOZ : TETRAHEDRON
HPG : THERMOGRAPHY
HPR : NOR
HQB : FEBRUARY
HQE : DISCLOSURE
HQQ : SHOULD
HRE : AN
HRJ : DEFECTIVENESSES
HRS : MORE
HSL : POPULAR
HSO : DETERIORATE
HSX : HIM
HSZ : TEARDROPS
HTC : DEINDUSTRIALIZE
HTJ : TOLBUTAMIDE
HTN : PROPOSAL
HTQ : HEARTACHES
HTS : DEMONSTRATIONAL
HUN : REQUIREMENTS
HUO : GREATER
HUQ : THEORY
HVM : DESTRUCTIONISTS
HVX : TOPOGRAPHY
HWH : TELEPHONIC
HWM : EDIFICE
HXI : DISBURSEMENT
HXQ : ADDITION
HYN : THOROUGHWORT
HYR : LACED
HYT : TURBELLARIAN
HZS : PRECISELY
HZW : DISENTANGLE
IAB : TRUE
IAI : DEPRECIATION
IAJ : EXCITED
IAM : EPSILON
IAQ : OPENNESS
IBB : EFFICIENT
IBU : RAPINE
ICJ : MIDWIFE
ICO : THAN
IDE : DEMINERALIZING
IDK : ENTITLED
IEA : LOST
IFL : DISCOLORATION
IFQ : DISCIPLINED
IFW : MIDYEAR
IGB : TRANSAMINASE
IGM : THERE
IGO : TRANSGENIC
IGR : DEPOSITORY
IGS : TORCHBEARER
IGT : MOST
IGU : CONSTITUTED
IHI : LODGED
IHR : DEFEASIBILITIES
IHU : SQUAD
IHX : TEST
IIE : WOULD
IIP : DISPOSSESSED
IIQ : DENOMINATIONAL
IKC : OURSELVES
IKT : ROAD
ILB : TRAJECTORY
ILJ : TOUCHSTONE
ILX : DELIBERATE
IMB : LEAVE
IMI : TECHNICIAN
IMM : MATHEMATICAL
IMY : EXPLOITATION
INE : PURPOSES
IOE : TURPENTINING
IOH : SUMMONS
IOW : EMPATHY
IPX : RUTHLESS
IPZ : ESPOUSE
IQA : DESTABILIZATION
IQD : ORGANISATIONS
IQK : EXPENDITURE
IQM : INJECT
IRJ : NEEDING
IRX : 
ISY : CORE
ISZ : DEMORALIZATIONS
ITS : DISCRIMINATE
ITT : MONSOON
IUG : THUNDERHEAD
IUI : DECRIMINALIZE
IUN : SHALL
IUS : COMPLICATED
IVB : INTENDED
IVD : DODECAPHONIST
IVK : CURVES
IVV : AMERICAN
IVZ : TENDINITIS
IWA : PLEDGE
IWG : RESPECT
IWO : DESPOLIATION
IWT : TARGETABLE
IWZ : DECARBURIZATION
IXB : DISPERSION
IXH : TANGENTIAL
IXL : ETERNAL
IXM : ELLIPTIC
IXN : MARTIAL
IXQ : B
IXZ : TETRAZOLIUM
IZN : MARSHALING
JAN : THOUGHTLESS
JAX : FORCE
JBF : EMBARGO
JBK : DISAPPOINT
JCC : DEBRIDEMENT
JCY : BROTHERHOOD
JDH : COMPELLING
JDU : DENATIONALIZED
JEN : MEXICO
JES : UPDATE
JEZ : DYSMENORRHEA
JFC : MEASURE
JFD : DESPITE
JFK : DEMATERIALIZING
JFO : TELEGRAPHIC
JGH : PEOPLE
JHL : PRESIDENTS
JHR : ARMS
JID : EQUATION
JII : THEOLOGICAL
JIR : I
JIY : EU
JJJ : AUGUST
JJT : BEHAVE
JKC : DESERTIFICATION
JKL : TWEEDINESSES
JKU : DIFFERENTIATE
JLB : STANDING
JLI : DISAGGREGATE
JLK : ASSURANCE
JMI : DIVERTISSEMENT
JMQ : TYPEWRITING
JMW : DISCOMPOSURE
JNB : DEVOLUTIONISTS
JNS : IRISH
JOA : DISCRIMINATION
JOO : HEADS
JPA : TREACHEROUS
JPB : AS
JPH : EASTERN
JQH : NUMBER
JSF : DIRECTORIAL
JSG : DECONSTRUCTION
JSI : TRANSCRIBE
JSK : MODULUS
JSP : SOME
JTK : THOUSANDTH
JTR : TYPOGRAPHER
JTS : TRENCHERMAN
JTW : THROMBOXANE
JUE : DETECT
JUF : DISCONTINUE
JUK : DISSATISFIED
JUL : VALUES
JVW : DELAMINATION
JVY : ACCOUNT
JWE : EXALTED
JWV : GITHUB
JXE : DISARMAMENT
JXO : DAUNORUBICIN
JYB : DESTRUCTION
JZG : SATISFYING
JZK : TESTDRIVE
JZL : MEANING
JZM : DESCENDANT
JZQ : DEHUMANIZATIONS
JZY : VULNERABILITIES
KAM : NATION
KAO : DELICATESSEN
KAW : AMONG
KBL : DESPICABLE
KBP : DRAMATURGICAL
KBQ : DOMICILIATION
KBR : TERMINABLE
KBS : WORTHY
KCG : DEFENSELESSNESS
KCO : TROJANS
KDJ : DISCREDITABLE
KEA : TREDECILLION
KEP : DEPOLARIZATIONS
KFI : TRENDSETTER
KFT : EXPLODE
KGB : HIDING
KGD : MASSIVE
KGE : ENVIRONMENT
KGU : SOVEREIGN
KGV : CHARACTERISTIC
KGY : TESTICULAR
KHK : BROUGHT
KHL : ENGAGED
KHW : MONITOR
KII : DECOMPENSATION
KIJ : MILLING
KIT : MATTER
KJA : ETCHING
KJM : EMPLOYEE
KJP : CONSISTS
KJT : TERGIVERSATE
KKA : DIPHENYLAMINE
KKC : TANTAMOUNT
KKD : ANY
KKG : DOXORUBICIN
KKW : TRANSLUCENT
KLA : DEXAMETHASONES
KLQ : FEELS
KMG : DELIVERANCE
KMH : MEANS
KMU : PROXY
KNB : SUBJECT
KND : DECLARATIVE
KNG : MEDICAL
KNH : NATIONS
KNI : REMARKABLE
KNP : DEFAMATION
KNT : WITHOUT
KNY : ASPECTS
KOM : ELUSIVE
KPB : DISCREPANCY
KPH : DELOCALIZATION
KPL : MOCKERY
KQV : SOON
KRA : EXCIMER
KRH : MOROCCO
KRJ : DIFFERENTIABLE
KRO : SIDE
KSQ : THUNDERCLAP
KSV : TELEUTOSPORE
KSY : RESOLVE
KTE : MEGABIT
KTO : GOOGLE
KTT : STUDIO
KTW : DETERMINANT
KUA : DIFFRACTOMETER
KUM : DESOLATION
KUQ : MUSTANG
KVA : DIAGRAMMATICAL
KVM : TRANSSEXUAL
KVS : INABILITY
KVY : ASK
KWJ : GENERATIONS
KWW : COMPANYORGANISATION
KXO : ORGANISED
KXY : DOWN
KYN : THYROTROPIN
KYV : COORDINATES
KZA : DISINGENUOUS
KZH : TACHYCARDIA
KZT : THIOSULFATE
KZW : MEETING
KZY : TRIFLURALIN
LAE : MERMAID
LAI : DEFENSIBLE
LBU : DISCONTINUITY
LBY : MILITARY
LCC : MQV
LCE : TRANSDUCTION
LCK : ONES
LCT : SECRETLY
LCW : PERFORMANCE
LCY : DETERMINATIONS
LDD : DISSONANCE
LDP : PROVIDE
LEF : ECOLOGY
LGF : RECONQUER
LGP : DELIQUESCENCES
LGT : TERATOGENIC
LHD : TERMINOLOGY
LHI : DISCONSOLATE
LHK : INDEPENDENT
LHZ : RULER
LID : INTELLIGENCE
LIV : DEALERSHIP
LIZ : SCHEMES
LJE : DEXTROROTATORY
LKC : RAGE
LKD : FAIL
LKF : TETRAHEDRAL
LKM : UNFETTERED
LKO : WORLD
LKR : THOUGHTFUL
LLD : INDIVIDUALANY
LLP : DEMATERIALIZE
LNC : WAY
LND : TRIATHLETE
LNX : DANGER
LNY : DENTICULATIONS
LOA : OBLIVIOUS
LOG : IM
LPP : DRIVETRAIN
LQC : THROMBOSIS
LQW : EVENTUAL
LRF : MARINER
LRI : DISAGREEMENT
LRJ : IS
LRU : ANOTHER
LRV : DEMANDINGNESSES
LRZ : BRUCE
LSY : DECLARE
LSZ : ASSUMING
LTC : HURRICANE
LTQ : OPENING
LTX : IN
LUA : TOTALIZATOR
LUD : DETERMINED
LUP : ECCBASED
LUQ : THEATRICAL
LUW : FALL
LVD : RELIGIOUS
LVJ : BEEN
LVN : EXTRACT
LWA : DIAPHANOUSNESS
LWF : DEPRIVATION
LWG : MANAGER
LWO : LEGITIMATE
LXK : PRACTICAL
LYM : DIPHTHERIA
LYS : MINIMUM
LZD : GOVERNED
LZI : DICHLOROBENZENE
LZL : AND
LZO : COMPROMISE
LZY : EQUATOR
MAB : THOROUGHFARE
MAM : DECISION
MAZ : DEFENSEMAN
MBD : MIGRANT
MBF : MACABRE
MCA : ISSUES
MCB : DILAPIDATED
MDG : DISGRACEFUL
MDR : EXPLOIT
MDZ : MINORITY
MEB : SPECIFIED
MEF : MALICIOUS
MEH : ENGAGE
MEO : TRANSGRESS
MEU : DETERMINATION
MEY : ABILITY
MFQ : TRIBULATION
MFT : MAILING
MFV : DISADVANTAGE
MFW : ON
MGC : PLAY
MGG : REDUCES
MGH : DIALECTOLOGISTS
MGK : DIVERTICULOSIS
MGR : STRICTNESS
MGV : DEVELOPERS
MHO : MARITAL
MHV : TAGLIATELLE
MIA : SUCCEEDING
MIE : MAGNATE
MII : ORIGINAL
MIQ : ELECTRO
MIT : PRODUCTS
MJF : DEMOGRAPHY
MJK : POSSIBLE
MJM : LATER
MJR : DIALECTOLOGIES
MKI : ROUTES
MLF : THERMOLABILE
MLO : DIFFICULTY
MMS : DISCRETION
MNA : MY
MND : DATATHE
MNH : ACCORDINGLY
MOL : DEMOGRAPHICS
MPD : DEMYTHOLOGIZED
MPF : ZIMMERMANN
MPN : ARE
MPR : TREMENDOUS
MPV : PUBLISHED
MQI : GROUPS
MQL : OVERFLOW
MQQ : COMMON
MQY : REMEMBER
MRD : INHERITED
MRG : VISUAL
MRJ : DISENFRANCHISE
MRM : LIBERTY
MRW : EVERY
MSK : LIE
MSO : DEJECTEDNESSES
MST : DISTRACTED
MTU : DEFINITION
MUK : MULTIPLICATION
MUO : TRANSPONDER
MUY : DEUTERAGONIST
MVU : EMPLOYEES
MWA : DOCUMENTARIAN
MWH : DEPERSONALIZE
MWL : DETERMINEDNESS
MYZ : DUPLICITOUSLY
MZF : DISTRESSED
MZS : DRAMATISATION
NAK : GENERATION
NBC : DISCOMBOBULATE
NBF : HEAVEN
NBV : THALIDOMIDE
NCK : DEVILISHNESSES
NCM : EVERYONE
NCQ : DEMONSTRATION
NCY : 	
NDN : MINIMAL
NDU : MARTINI
NED : DELIBERATIONS
NFG : DOMINEERINGLY
NFK : QUIETLY
NFL : THUS
NFR : MASONRY
NFV : DRAFTSPERSON
NGA : RUIN
NGB : DEHYDRATION
NGH : COMPUTER
NGI : DISUBSTITUTED
NGS : DENAZIFICATIONS
NGX : DEVOTIONAL
NHA : THE
NHI : THEREBY
NHJ : OH
NHT : TRILATERAL
NIH : EXTINGUISHED
NIO : NARROW
NJB : DETACHABILITIES
NJD : DELETERIOUS
NJM : WHERE
NJP : DIAZOTIZATIONS
NJZ : TRAVELOGUE
NKB : ENFORCED
NKD : TRANSMONTANE
NKE : HENCE
NKG : SWEETNESS
NKM : EARTH
NKN : POUR
NKU : TYPEWRITER
NKX : ADD
NKZ : EXPLORE
NLW : TRAMPOLINE
NMB : FAKE
NMQ : DEMOCRATICALLY
NNC : ACCOMPLISH
NNH : ASSUMED
NNI : WHOSE
NNN : STANDARD
NNX : AT
NNZ : SPEARPHISHED
NOC : PENETRATE
NOD : ARTICLE
NOI : PRAY
NOS : TYPEFOUNDING
NOX : PROCESSING
NPC : THISTLEDOWN
NPD : DUPLICITOUS
NQI : TETRAHEDRITE
NQO : DISCONTENT
NQU : LYRICS
NQY : ECHELON
NRK : SEVEN
NSI : MADNESS
NSO : THEREFORE
NSR : FOREIGN
NSU : DISCRIMINANT
NTE : DISCERNMENT
NTQ : CULPRIT
NTU : FAMOUSLY
NTX : MANAGE
NUG : DISJUNCTIVE
NUL : MIDWEEK
NVI : DISCOURAGE
NVN : CONDITIONS
NWK : GROUP
NWM : COMPOSED
NXL : EXPENSE
NYC : REASONS
NYR : PART
NYT : IVE
NYV : CAN
NYY : DECALCOMANIA
NZB : PATIENCE
NZM : YET
NZU : DETECTED
NZZ : REMAINED
OAP : CRYPTOSYSTEMS
OAQ : DISCONTENTED
OBK : CREDENTIALS
OBT : PAGE
OBU : TYPEWRITINGS
OCV : OUR
OCX : TELESCOPIC
OCY : PERSONS
ODB : DEODORIZATIONS
ODM : DECEPTIVELY
ODN : TECHNOPHOBIA
OED : KNOW
OEE : DELUSIVENESSES
OEI : TRANSFIGURE
OEQ : WEIL
OER : DRAMATIZATION
OES : DISFRANCHISE
OFE : DEFEASANCE
OFN : DISTRIBUTION
OFV : CONFIGURATION
OGG : DIALECTOLOGIST
OGN : TETRACYCLINE
OGR : TERPOLYMER
OHJ : SUNSPOT
OHV : NAME
OHZ : PARTS
OIF : DELECTABILITIES
OII : HEREBY
OIS : DELIRIOUSNESSES
OJE : AGENCY
OJF : HUNDRED
OJG : TRANQUILIZE
OJQ : USURPATION
OJV : SKIES
OKE : DEMARCATION
OKL : DEUTERAGONISTS
OKW : CLAIMS
OLH : MEET
OLN : TIMBERLAND
OLO : TURPENTINE
OLT : TRANSLATION
OLW : DECLARATION
OLZ : HONESTY
OMI : DECENTRALIZE
OML : DUALISTICALLY
ONF : MIGHT
ONP : MAPPING
ONZ : DISCOGRAPHY
OOZ : MILITIA
OPB : TAMBOURINE
OPD : DELIBERATIVELY
OQS : TOTALITARIAN
OQV : MIDTERM
ORA : TINKER
ORB : DISSECTION
ORF : MYSTERY
ORO : DISREPUTABLE
ORR : ENDEMIC
OSC : SOMETHING
OTF : OBTAINING
OTJ : ME
OTQ : DRAW
OTT : HELP
OTX : THROUGHOTHER
OUU : DIAGENETICALLY
OUX : CROPPED
OVD : DECOMPRESSION
OVH : ALLOWS
OXC : DISSIPATION
OXH : HOUR
OXJ : DEFENSIBILITIES
OXK : ENCOMPASSES
OXQ : DISAPPOINTMENT
OXT : CAUGHT
OXZ : TYPEFOUNDERS
OYE : MATINEE
OYH : DERMATITIS
OYV : TYPESCRIPT
OZB : SUGGESTION
OZH : ENTRANT
PAA : DELECTABLE
PAN : SEEN
PAY : TIME
PBG : THORACOTOMY
PBQ : PAIRINGS
PBU : AMERICA
PBZ : TRADITION
PCI : TETRODOTOXIN
PDN : COMING
PEI : DISACCHARIDASE
PEJ : EITHER
PEV : TUMORIGENIC
PFC : INVITE
PFE : UNDERLYING
PFQ : DISINTEREST
PFX : DENATURALIZE
PGM : MUST
PGX : NEEDS
PIB : DISCOMFITURE
PIL : DICTATORIALNESS
PIS : ADAPTED
PIX : EMPEROR
PJD : MINDFUL
PJL : CHARTER
PKJ : TRIFOLIOLATE
PKS : MISSING
PKU : DIASTEREOMERIC
PKZ : TRANSFERASE
PLO : DEMONETIZATIONS
PLV : STORAGE
PLW : CONTROL
PMU : STARTS
PNF : RIGHT
PNQ : DISEQUILIBRIUM
PNW : STATEMENT
POL : DESTINATION
PPR : DEMOBILIZATION
PPU : OWN
PQD : OBLIGATION
PQH : DICHLOROETHANE
PQK : THEOPHYLLINE
PQT : STANDS
PQZ : RIGHTS
PRU : MARRIED
PSI : DEDUCTIBLE
PSL : TUBERCULOSIS
PSS : BUT
PSV : INFORMATION
PTD : DRAFTSMANSHIP
PTN : BATCH
PTP : HONOR
PTR : TECHNOLOGIST
PTX : DENOMINATION
PTZ : TECHNOLOGY
PUO : DIENCEPHALON
PVE : DEXTEROUSNESSES
PVK : DEFLECTION
PVO : DIVISOR
PVP : TRANSMITTER
PWI : GIVEN
PWS : MODULAR
PWX : TACHOMETER
PXA : MONTAGE
PXE : EMPOWER
PXJ : TUMBLEWEED
PYB : RSA
PYM : TERMINATION
PZK : MONARCH
PZR : DOUBTLESSNESS
PZS : INFRINGING
QAA : FOLLOW
QAF : DELIBERATIVE
QBD : THANKSGIVING
QCQ : EVASIVE
QCS : ESTUARY
QDH : MUSTARD
QDQ : DEPOSITION
QDR : UNSUCCESSFUL
QDS : DIELECTRIC
QEK : DISABILITY
QFB : DECONCENTRATE
QFD : TRANSPACIFIC
QFE : COMBAT
QFM : TASK
QFO : DETUMESCENCE
QFS : YOU
QFW : SECRET
QGF : DEMOLITIONISTS
QGJ : WELLINGTON
QGL : SIMILAR
QGO : DOCUMENTALIST
QGV : INTENSE
QHF : DEMOCRATIZE
QHH : THROTTLEHOLD
QHI : DESPERATION
QHK : GUARANTEES
QHR : DEPIGMENTATION
QIH : MAILBOX
QIJ : DEPENDABILITIES
QIT : CURVE
QIV : WORKED
QIX : RELYING
QJF : SUPPORTED
QJM : GREEK
QJN : DEXAMETHASONE
QJY : DISCIPLINARY
QJZ : ECLIPSE
QKE : DESCRIPTION
QKH : EMERALD
QKW : MOVABLE
QLC : ELEMENT
QLF : SIGNIFIES
QLN : MAESTRO
QLS : ENTROPY
QMC : PROPER
QML : DEHYDROGENATION
QMM : SMALL
QMO : WHICH
QMP : ECMQV
QMR : CRYPTOGRAPHIC
QNE : THIMBLEBERRY
QNL : DOWNSTAIRS
QNU : DEGRANULATION
QOL : ENQUIRE
QOM : INDIVIDUAL
QOO : MIXTURE
QOZ : EXAMINE
QPJ : DISSIMILITUDE
QPM : SORT
QPT : DEMILITARIZING
QPW : FELLOWS
QQD : CURRENT
QQJ : CHILDREN
QQV : CRYPTOLOGY
QRB : THICKENING
QRH : FAIR
QRO : EYEBALL
QRW : DELIGHTFULNESS
QRZ : DEMORALIZINGLY
QSX : DENOMINATIVE
QSY : ECDH
QTJ : DISSIMILARITY
QTT : DETERRENCE
QTX : MASKING
QUF : DIPPED
QUJ : REACH
QUR : MERCURY
QUV : SIX
QUW : DISINFECTANT
QUX : DIAGONALIZABLE
QVM : TABLESPOON
QWA : SUCH
QWN : DONNISHNESSES
QXR : FORM
QXZ : NOW
QYD : TRIGEMINAL
QYT : PROCESS
RAI : FOUND
RAM : NEED
RBE : PROBLEMS
RCG : IMBUED
RCJ : DIVERTIMENTO
RCS : TRAINED
RDG : RAT
RDH : DESPIRITUALIZED
RDS : PREMISE
REA : NO
REC : NOTCH
REP : DETERIORATIONS
REX : DEMORALIZATION
REZ : DISTRUSTFUL
RFG : BEGIN
RFK : ARMFUL
RFU : WILL
RGO : DEFEAT
RGZ : DISASTROUS
RHI : DECLARATORY
RHV : FACED
RIM : FREEDOM
RIV : TRADESCANTIA
RKI : DEPOSITARY
RKJ : DESIRABLENESSES
RKK : USED
RKZ : DENUNCIATION
RLD : COMRADES
RLG : DRUNKENNESSES
RLL : GOD
RLS : TYRANNOSAUR
RMC : READINESS
RMK : DISCOMFORT
RMN : DELICIOUSNESSES
RMU : CUSTOM
RNM : CALL
RNV : DIAGNOSTICIAN
ROG : TOURNIQUET
ROJ : DEHYDROGENASE
ROL : EXPRESS
RPF : SPRAYING
RPW : DISSIMILATION
RPY : COLD
RQL : DOMESTICATION
RQN : TRAILBLAZER
RQS : DESTRUCTIVE
RRE : UNDER
RRM : SIGNATURE
RRN : INTRACTABILITY
RRT : ALLEGIANCE
RRX : MALAISE
RSE : THROUGHOUT
RSP : FELLOW
RSU : ELITISM
RTG : CERTAINLY
RTK : INSERTING
RTN : WERE
RTT : AGAINST
RUD : DOCUMENTABLE
RUN : DISCONFORMITY
RUQ : MATCHUP
RVI : DICHOTOMOUS
RVN : INJECTED
RVV : GAMES
RWC : DEPENDS
RWR : TRICHOPTERAN
RXE : MAPPINGS
RXK : TWO
RXN : DIASTEREOISOMER
RXS : MELODIC
RXT : REGULATIONS
RXZ : WAITED
RZB : SEPTEMBER
RZK : MONTHS
RZL : DOPPELGANGERS
RZN : DISTINCTION
RZT : DISINCLINATION
RZU : NEVER
SAP : DIASTROPHICALLY
SBK : DEATHLESSNESSES
SBL : TRADITIONAL
SCA : OTHER
SCN : DETERMINATIVES
SCR : COMMISSION
SDA : DECONSTRUCT
SDE : JAPAN
SEA : CARRIED
SEF : DENUCLEARIZING
SEG : DELETERIOUSNESS
SEL : DISRESPECTFUL
SET : EXILED
SFJ : TROPHALLAXIS
SFT : RESOLUTELY
SFZ : DISSIMILAR
SGA : DERMATOGLYPHICS
SGC : TOLERATION
SGN : ADVANTAGE
SGU : TRANSITIVE
SGV : FOLLOWING
SHF : MAMMOTH
SIN : FIVE
SIS : TROUBLESOME
SIT : ABELIAN
SJN : PROTECTED
SJR : INFEASIBLE
SJV : TORCHLIGHT
SKT : DOWNHEARTEDLY
SLF : DEPENDABLE
SMC : DIMENHYDRINATE
SME : DEROGATORY
SMG : DISEQUILIBRATE
SMJ : THOSE
SMT : EMPLOYMENT
SMW : DOPAMINERGIC
SNB : TELL
SNE : BEING
SOC : THUNDERSTORM
SOL : BLESSING
SOQ : DISPOSITIVE
SOS : DINUCLEOTIDE
SOV : POINT
SPI : EMINENT
SPX : DISINCLINED
SPZ : EDITION
SQM : DISTURBANCE
SRA : ENGLAND
SRL : PUNISHMENT
SRP : DESTABILIZE
SRV : IDENTITYBASED
SRW : DOCUMENTARIST
SSB : TRIMETHOPRIM
SSK : DISILLUSION
SSP : DIRECTIONAL
STC : REPUBLIC
STO : ENDORSED
STW : DOPPELGANGER
SUR : TRACHEOPHYTE
SUT : PROVE
SUZ : AUTHORITYTHIS
SVU : CIRCUMSTANCES
SWD : YEARS
SWG : LEADERS
SWN : HEIGHT
SWQ : DEMONSTRATIVES
SXK : DISHONOUR
SXQ : INSIDE
SYC : COMPARISON
SZA : SOLUTION
SZK : DEUTERANOMALIES
SZP : BOTH
SZQ : SIGNED
SZU : MISLEAD
TAL : DISADVANTAGED
TAU : ELDERLY
TAZ : DIAGNOSTICIANS
TBC : THOUGH
TBI : DIAMONDBACK
TCF : PROBLEM
TCH : WOODEN
TCI : THEREUNDER
TCN : MAGICAL
TCX : INCLUDING
TDA : ABOVE
TDB : DIFFRACTION
TDN : USES
TDP : MASCARA
TEA : EYEWEAR
TEI : WHETHER
TEX : LAST
TFB : ENTERIC
TFK : CONSTANT
TGG : ENCLAVE
TGI : SECURITY
TGJ : ECDSA
TGQ : TROUBLEMAKER
THP : TECHNOPHILE
THV : UNRESTRICTED
TIJ : ENGINEERS
TIO : DIABETOLOGISTS
TIT : ORION
TIX : SUPREME
TIZ : ENCLOSE
TJI : DEMYTHOLOGIZES
TJW : DISPASSIONATE
TKC : TASKMASTER
TKX : MANSION
TLB : HAVE
TLC : COMPRISES
TLH : SINCERELY
TMC : GAINING
TMH : DOXYCYCLINE
TML : CONFERENCE
TMM : DISORDERED
TMU : DISINCENTIVE
TMY : EPITOME
TMZ : DENSIFICATIONS
TNF : DEPRESSION
TNI : AGREEMENT
TNK : TRANSFEROR
TNR : SERVES
TOA : CONSTANCY
TOC : EXCLUSIVELY
TOE : DETOXIFICATION
TOH : INTEGRITY
TOK : DIVESTITURE
TOP : THERMOMETER
TOX : KEEP
TOZ : EMOTION
TPB : DOLEFULNESSES
TPD : INTO
TPE : DEUTERANOMALOUS
TPV : THALASSAEMIA
TPY : WE
TQA : EXHIBITING
TQL : LOW
TQP : DISRESPECT
TRD : ORDER
TRG : EXTENT
TRI : SNAKES
TRL : SEIZES
TRN : CLASSIFIED
TRS : REASON
TSK : TURBIDIMETER
TSU : DEMAGNETIZATION
TTT : DISPENSATION
TTV : ENCRYPTION
TUJ : UNDISMAYED
TUN : TROJAN
TVD : SIGNALS
TVJ : CONCERNING
TVL : DORSOLATERAL
TWD : TOWNSPEOPLE
TWX : EXPANSE
TYM : DOGMATIZATION
TZI : TRANSPICUOUS
UAB : SERVICES
UAO : HAVING
UAR : TRANSIENCE
UBI : COMPLETE
UBT : DESTRUCTIBLE
UBZ : OFFERS
UCA : GRADUATIONS
UCB : DESULFURIZATION
UDF : GOT
UDK : DEMINERALIZE
UDN : DEPERSONALIZING
UDS : DETAILED
UDZ : TROUBLESHOOT
UEG : FROM
UEH : GIANT
UEL : TECHNOLOGIZE
UEW : DETAIL
UFI : DECARBOXYLATE
UFY : TRADESPEOPLE
UGC : UNDERSTOOD
UGX : DAYLIGHTING
UHL : ENDLESS
UHN : COMPLIANCE
UHR : DEREALIZATION
UHT : VALOUR
UHV : ECC
UIB : NSA
UID : DEFERVESCENCE
UIE : LAWFUL
UIH : TWELVEMONTHS
UIN : MAJESTY
UIU : DEGLAMORIZATION
UJE : TRICHROMATIC
UJF : TRIUMPHANT
UJT : DOWNSTREAM
UJW : FORGET
UKE : TIMBERLINE
UKH : DISINHIBITION
UKP : EPISODE
ULK : TEXAS
ULQ : PASSES
ULZ : MILLION
UMA : TRANSLATOR
UMC : THEREABOUTS
UMJ : TENDER
UMR : DELEGITIMATION
UNB : TERRITORIAL
UNE : PROCLAIM
UNF : DECAFFEINATED
UNT : EXHAUST
UOF : FAMILIAR
UOI : DECARBOXYLATING
UPD : TIMESAVING
UPI : THENCEFORTH
UPP : DOMESTICATING
UQF : UNDERTAKE
UQM : DEVOLUTION
UQP : TUBOCURARINE
UQT : THAT
URA : DENITRIFICATION
URI : DOWNRIGHTNESS
URP : AFRAID
URW : EARSHOT
USR : WHEN
UTE : DEMYTHOLOGIZING
UTO : DESTITUTION
UUA : A
UUJ : DISCOVERED
UUS : ENCRYPT
UUV : DETAILEDNESSES
UVA : TRUSTWORTHY
UVI : COURAGE
UVT : DISCERNIBLE
UVW : DEMOGRAPHIC
UWC : TESTOSTERONE
UWP : TRANSHUMANCE
UWY : BALANCED
UXB : DISAPPROVE
UXN : PERSONAL
UXX : EARNEST
UYD : CRYPTOGRAPHY
UYF : DISCRETIONARY
UYQ : TRAITOROUS
UYT : DIMINUTION
UYV : THESE
UYZ : SOLARWINDS
UZR : THEMSELVES
VAA : DISCRETE
VAW : PATIENTLY
VBC : DISCOURTEOUS
VBD : THIOCYANATE
VBN : AMERICANS
VBR : DECONTAMINATE
VBZ : LOOK
VCC : SHE
VCF : ITLL
VDM : DUBIOUSNESSES
VDQ : FACE
VDU : DISSEMINATE
VEU : AIMED
VFN : DIVERSIONIST
VFZ : ART
VGB : DEMYTHOLOGIZERS
VGM : DESTITUTENESSES
VGX : CARRY
VGY : FIXED
VGZ : BE
VHL : MALARIA
VHY : TROUBADOUR
VHZ : DOCTRINAIRISM
VIA : THEORETICIAN
VIC : VIRTUES
VID : VARIETY
VIN : DESIGNATION
VIO : DISSOCIATION
VIX : SUBDIVISIONS
VJH : TOASTMASTER
VJQ : NECESSARY
VJR : RECOGNIZE
VJS : TRANSDUCTANT
VKC : TAMPERPROOF
VKH : JUST
VKI : TEMPTATION
VKR : DEPENDENCE
VKX : EXPLANATIONS
VLB : STILL
VLC : OPERATIONS
VLL : DISESTABLISH
VLV : DISCLAIMER
VLW : MISTAKE
VMH : MANHOOD
VMV : OPPORTUNITIES
VNA : TRIUMPHALISM
VNE : MIRACLE
VNF : EIGHT
VNI : CASES
VNN : YOURSELF
VNO : TOGETHER
VNR : DPC
VOE : DENSITOMETRIES
VOK : JUDGMENT
VOV : EARLY
VOX : REWARD
VPD : OPEN
VPK : TURBULENCE
VPQ : DEMOCRATIC
VPY : DEVITRIFICATION
VQN : USING
VQQ : SEVERAL
VQX : THREADBARE
VRO : WELL
VRW : MODESTY
VSE : SERVICE
VSM : SAME
VSQ : DISPENSABLE
VST : REVEAL
VTH : DOLLISHNESSES
VTI : PASSWORD
VTK : SPEEDY
VUE : DECARBOXYLATION
VUT : DECORATION
VUW : DICOTYLEDONOUS
VVH : BILINEAR
VVM : DEFIBRILLATE
VVQ : THIRTEENTH
VWB : SITE
VWN : DESPONDENCY
VWS : DISJUNCTION
VXB : PROSPERITY
VXH : SACRIFICE
VXK : DEPLOYED
VXU : THUNDERBIRD
VYI : WIRE
VYM : QUITE
VYS : MARSHAL
VYX : ALGORITHMS
VZR : DELIGHTEDNESSES
WAC : HAD
WBA : THROUGH
WBD : DIABOLICAL
WBU : LARGE
WCG : GRUNT
WCI : DISHONORABLE
WDA : DIVIDED
WDI : DERMATOPHYTE
WDJ : TIGHT
WDV : SUPPORT
WEB : DISCONTINUOUS
WED : DEVELOPMENT
WEH : KEYS[]
WEI : DOCUMENTARILY
WES : DISPROPORTION
WFB : DOMESTICITIES
WFF : LODGE
WFS : THING
WGN : INQUIRY
WGR : EXPIRED
WGS : DEMONSTRATIVELY
WGW : ORGANISATION
WGZ : TURNAROUND
WHE : DETERMINABLE
WHM : DETERRABILITIES
WHT : METRICS
WHX : DUODECILLIONS
WIE : TERMINATOR
WIH : MACHINE
WIR : ENVIRON
WIZ : SUBMARINE
WJQ : FOR
WKJ : BENEVOLENCE
WKO : TERATOLOGY
WKQ : DISTINGUISH
WKW : DISCUSSION
WLE : DECOMPOSITION
WLI : TURBULENCIES
WLK : DIACHRONICALLY
WLO : TRANSURANIC
WLQ : OWNERSHIP
WLT : FLAG
WLZ : LOADING
WMI : MISSERVE
WML : DEATH
WNE : THUNDERBOLT
WOO : DEPORTATION
WOU : GALLANT
WOV : DO
WPB : DEMINERALIZERS
WPD : TRANSITORY
WPT : ENFORCE
WQA : DOMICILIATING
WQB : DICHOTOMOUSNESS
WQF : DERELICTION
WQI : PUBLICS
WQK : DIGITAL
WQO : DIALECTICIAN
WQQ : HONORABLY
WQW : TRANSPARENCY
WRB : SIGNCRYPTION
WRD : TROCHANTER
WRK : STEP
WSB : DRAFT
WSN : ALONG
WTX : EYEBROW
WVH : DISINFLATION
WVJ : UNDETECTED
WVL : DEPOLITICIZE
WVM : DOUBLESPEAKER
WVQ : TOOK
WWI : DRIVABILITIES
WWX : LONG
WXG : MUSIC
WYM : DECASUALIZATION
WYP : DECLARES
WYX : IRELAND
WZB : PRODUCT
WZG : LOVE
WZH : ACCESS
WZI : SIMPLY
WZJ : PRIME
WZR : AGENCYCENTRAL
WZU : SIGNATURES
WZZ : COULD
XAI : EXCERPT
XAR : MONSTER
XBV : PLAUSIBLE
XCI : PLENTY
XCX : LAWS
XDB : DESCRIPTIVE
XDN : TROY
XDV : DISPLEASURE
XDZ : DEMISEMIQUAVER
XEB : GDPR
XEH : DISSEMINATED
XEO : RECTIFIED
XEP : HIGH
XEQ : INTEND
XEU : DETERMINATENESS
XEV : OR
XFB : TURBIDIMETRY
XFC : UH
XFN : DISCRIMINATOR
XFS : DESCRIPTIVENESS
XGW : TAKE
XGZ : JANUARY
XHC : RAINBOWS
XHD : DEPLORABLE
XHE : METHOD
XHM : DISPOSABLE
XHP : MANATEE
XHS : MEDIATE
XHW : TRIUMVIRATE
XHX : KNOWS
XIA : DEFIBRILLATOR
XII : BASED
XIS : RECENTLY
XJI : CONSIDERATIONS
XJP : TURGESCENCES
XKE : TABERNACLE
XKK : THEREAFTER
XKL : ERRATIC
XKU : AFFAIRS
XKY : GROUNDED
XLC : TURTLENECKED
XLM : EPITHET
XLR : THEM
XMT : TEMPESTUOUS
XMV : HURRY
XNC : SO
XNU : EMULATE
XOD : DISAMBIGUATE
XOH : EXHIBIT
XON : WELFARE
XOO : SYSTEMS
XOR : MAXIMUM
XOV : THOROUGHBRED
XOX : TOES
XPB : PERSON
XPG : ANALOGY
XPY : POSSIBLY
XPZ : SMALLER
XQA : GOVERNMENT
XQF : NATIONAL
XQN : SCHEME
XQX : ADMINISTER
XRR : GETTING
XSC : DOMESTICITY
XSM : HIRE
XSW : VITAL
XTA : EACH
XTC : ACTUAL
XTD : WASNT
XTE : LET
XTP : THALASSEMIA
XUC : HACKED
XUM : THREATENED
XUP : MOMENT
XUT : DESIGNED
XUY : DIATOMACEOUS
XVE : SIZE
XVK : TRIPHOSPHATE
XVN : DISPROPORTIONAL
XVT : VERY
XVU : HIGHLY
XVZ : HOLD
XWC : FINANCIAL
XWE : LEVEL
XWG : HAS
XWV : DISTILLATION
XXD : ENQUIRY
XXS : REPOSITORY
XXY : TELEGRAPHESE
XYB : ALGORITHM
XYL : TOXICOLOGY
XYW : GENERAL
XZG : SOUNDING
XZZ : DETERMINATE
YAA : SUITE
YAB : TABS
YAE : FURIES
YAX : DISAGREEABLE
YBD : THREE
YBR : PEACE
YBU : ORDERS
YCG : ATTENTION
YCL : WORRY
YCW : THERMOSPHERE
YDD : INFORM
YDE : DEMONSTRATIVE
YDN : WHOLE
YEE : MARKING
YEK : STRENGTH
YEP : DIFFERENTIATION
YEQ : LIVES
YEW : LOGARITHMBASED
YEZ : TIMES
YFB : DEFICIENCY
YFD : MORNING
YFE : MARQUIS
YFP : EXALTATION
YFQ : THROUGHPUT
YFW : MOORING
YGG : TELECOMMUTE
YGI : OPPORTUNE
YGK : DENATURALIZING
YGV : CITIZENS
YHF : RESEARCHER
YHN : DISCLAMATION
YIF : PROTECTING
YIO : DUPLICATION
YIS : RIGOROUSLY
YJD : ARIZONA
YJO : DEGENERATION
YJZ : UNITED
YKF : NEUTRAL
YKS : DOUBLESPEAK
YLI : THERMOMETRY
YML : DEMONSTRABILITY
YNB : EYE
YNI : DISSOLUTION
YNZ : DISRUPTIVE
YOF : TRANSVERSE
YOQ : DISAPPROBATION
YOW : TURTLENECK
YPD : TEMPERATURE
YPE : TRANSVESTITE
YPQ : WHILE
YPS : REGARDLESS
YPU : TRAILBLAZING
YPY : TASKMISTRESS
YQA : OPERATION
YQE : MISSIONS
YQU : DISTASTEFUL
YRE : CITIZEN
YRK : TRUST
YSA : GENERALS
YSD : PRESIDENT
YSR : DISTRIBUTARY
YTJ : DEAD
YTQ : MINERAL
YUD : TROPOSPHERE
YUF : TRANSACTION
YVA : REVOLUTIONARY
YVV : NIST
YWG : TELEPRINTER
YXC : ROADS
YXI : TRANSCRIPT
YXK : DONT
YXO : GREAT
YXQ : DEMONSTRATE
YXZ : REPRESENT
YYA : DESPAIRING
YYI : DREAMLESSNESS
YYN : HER
YYP : TOOTHPASTE
YZD : TASKS
YZJ : TRANSDERMAL
YZN : TRIANGULAR
YZV : TRIVIALITY
ZAE : SAVIN
ZAS : FEDERAL
ZBS : CHANCES
ZCH : DIAGNOSTICALLY
ZCP : TAILORING
ZCV : RATE
ZCW : DISTRAUGHT
ZDF : MODEST
ZDG : DIRECTORATE
ZDM : DECONGESTANT
ZDU : DIFFIE–HELLMAN
ZDV : EDUCATE
ZDY : PAIRINGBASED
ZED : FAIRLY
ZEE : ITS
ZEJ : DISCERNING
ZEX : PURSUE
ZFM : ARMY
ZFQ : THEORETICAL
ZFR : ENDEAVOR
ZFV : FACT
ZGR : SLEEVE
ZGT : DETRIBALIZATION
ZGU : MUNDANE
ZHA : REPORTERS
ZHI : DESTINIES
ZIV : HARM
ZIY : ALSO
ZJB : UP
ZJE : TRANSCEIVER
ZJL : THERMOSTABLE
ZJN : TEAM
ZJX : ALLIANCE
ZKD : SERVE
ZKI : DOCUMENTARY
ZKW : WISE
ZLM : DETOXIFICATIONS
ZLN : DIFFERENTIAE
ZMC : TENDERLOIN
ZMD : DEFINITIVE
ZMH : MORAL
ZMJ : INTRODUCED
ZML : TUMULTUOUS
ZMM : WAS
ZMN : PROVISIONAL
ZMO : DIALECTOLOGICAL
ZNC : DISCIPLINABLE
ZNL : MIGRATE
ZNR : SOMEWHAT
ZOF : LAID
ZOK : RECOMMENDED
ZOR : MIDLAND
ZOS : KISS
ZPM : PROTECT
ZQL : EMBRACE
ZRA : DISQUALIFY
ZRB : DISARTICULATE
ZRC : FINE
ZRI : DIMINUTIVE
ZRS : DISAPPOINTING
ZSA : DEGENERATIVE
ZSX : EVER
ZTH : DESENSITIZATION
ZTK : EQUIVALENT
ZTL : MENDING
ZTN : CAUSES
ZTS : EXCHANGE
ZTZ : FACTORS
ZUL : THEOCENTRIC
ZUU : INTERESTS
ZUV : MANAGED
ZVR : CONSTITUTION
ZWQ : ESSENCE
ZXK : EMANATE
ZXX : FIRST
ZYD : DEPRESSURIZE
ZYR : DISADVANTAGEOUS
ZYX : DEVELOPING
ZZC : PUBLICLY
ZZK : DOUGHTINESSES
ZZL : UNRELATED
